{
  "600020": [
    "BK0685",
    "BK0700",
    "BK0683",
    "BK0604",
    "BK0506"
  ],
  "000001": [
    "BK0521",
    "BK0732",
    "BK0811"
  ],
  "000002": [
    "BK0423",
    "BK0556",
    "BK0683"
  ]
}